┌──────────────────────────────────────┐
│ ╔════════╦══════════════╦══════════╗ │
│ ║        ╠══════╦═══════╣     ╥    ║ │
══╬════════╣      ║       ╨    ╞╬╡   ║ │
│ ║        ╨      ║             ╨  ◉ ║ │
│ ╠════╦══════════╩════════════════╣ ║ │
│ ╨    ╚══════════════════════╗    ║ ║ │
│   ╔═════════════════════════╬═╗  ║ ║ │
│   ║    ╥                ╥   ║ ║  ║ ║ │
│ ╥ ║   ╔╩════════════════╣   ║ ║  ║ ║ │
│ ║ ║   ║           ╥     ║   ║ ║  ║ ║ │
│ ║ ║   ║   ╥       ║     ║   ║ ║  ║ ║ │
│ ║ ║   ║   ╚═══╦═══╩═════╝   ║ ║  ║ ║ │
│ ║ ║   ║       ╚═════════╗   ║ ║  ║ ║ │
│ ║ ║   ║                 ║   ║ ║  ║ ║ │
│ ║ ║   ╠═════════════════╝   ║ ║  ║ ║ │
│ ║ ║   ║    ╞════════════════╝ ║  ║ ║ │
│ ║ ║   ╚═══════════════════════╝  ║ ║ │
│ ╚═╬════════════╦═════════════════╝ ║ │
│   ╚════════════╩═══════════════════╝ │
└──────────────────────────────────────┘
